111111
11C011
1C1011
101P01
100011
111111