1111111111111
10C0000C000C1
1000011110001
1P0011EC000C1
1111111111111