1111111111111111111111111111111111
1E0000000000000C00000C000000000001
1010010100100000101001001110010111
1010010010101010C01001111010011101
10100100101C1010001001000011110101
100000000C00C0000000000000000000P1
1111111111111111111111111111111111
