1111111
1000C01
1E0C011
10C0P01
1111111
