11111111111111
1C00000C000C01
10C1110C011001
1E010C00010001
11010011110001
1001111C000P01
1000C0100C1101
11111111111111